##############################
#............................#
#....####............####....#
#....d..#....p.i#....#X.#....#
#....#.S#.......#....#..D....#
#....####..U+.#......####....#
#...........#....N...A....c..#
#...H..t..n..#..m............#
#..............E.....F.......#
#....b.......####.......i....#
#......k.....#.r#............#
#...............#............#
##############################
