##############################
#............................#
#....####...........#####....#
#.......#...........#........#
#....#.S#...........#...#....#
#....####...........#####....#
#............................#
#............................#
#............................#
#..........######............#
#...............#............#
##############################
