##############################
#............................#
#....####............####....#
#....d..#....p.i#....#X.#....#
#....#.S#.......#....#..D....#
#....####..U+.#......####....#
#..vk.g.....#....N...A....c..#
#...H..t..n..#..m.f..........#
#..............E.............#
#....b.......####.......i....#
#............#.r#............#
#...............#............#
##############################
