##############################
#............................#
#....####............####....#
#....d.......p.i#....#X.#....#
#....#.S........#....#..D....#
#....##....U+.#......####....#
#...........#................#
#............#...............#
#........m...................#
#............####............#
#............#.r#............#
#...............#............#
##############################
