########################
#....L.....###.....M...#
#..S..###..P..I..C..D..#
#......#...............#
#..H..#..###..#####..UT#
#..F..#..m..#####..G...#
#..N..#..r..#####..E...#
#......#...............#
#....P....####....P....#
#....X....####....R....#
#....C....L.....I......#
########################
