##############################
#....E.....T..............C..#
#....####............####....#
#....d...b..p.i#....#X.u.....#
#....#.S........#....#..d....#
#....##..U+.#..F...####...N..#
#...A.......#...........o....#
#............#...............#
#.....m......................#
#....o.....####.......r......#
#............#.r#............#
##############################
