##############################
#............................#
#....####............####....#
#....d..#....p.i#....#X.#....#
#....#.S#.......#....#..D....#
#....####..U+.#......####....#
#...........#................#
#............#...............#
#............................#
#............####............#
#............#.r#............#
#...............#............#
##############################
