##############################
#....E.......................#
#....####...........#####....#
#....d..#b..p.i.....#X..u....#
#....#.S#...........#...#....#
#....####U+.........#####....#
#............................#
#............................#
#............................#
#..........######.....E......#
#...m..........r#............#
##############################
